####################
#........##........#
#.##.###.##.###.##..#
#o#......P.....#o.#
#.##.#.######.#.##.#
#....#....##....#..#
####.###G####.###.##
#........##........#
####################
