############
#   G  .   #
# . #  . P #
#   .  .   #
############